P                                                                                                                                                   P
P                                                                                                                                                   P
P                                                                                                                                                   P
P                                                                                                                                                   P
P                                                                                                                                                   P
P                                                                                                                                                   P
P                                                                                                                                                   P
P                                                                                                                                                   P
P                                                                                                                                                   P
P                                                                                                                                                   P
P                                                                                                                                                   P
P                                                                                                                                                   P
P                                                                                                                                                   P
P                                                                                                                                                   P
P                                                                                                                                                   P
P                                                                                                                                                   P
P                                                                                                                                                   P
P                                                                                                                                                   P
P                                                                                                                                                   P
P                                                                                                                                                   P
P                                                                                                                                                   P
P                                                                                                                                                   P
P                                                                                                                                                   P
P                                                                                                                                                   P
P                                                                                                                                                   P
P                                                                                                                                                   P
P                                                                                                                                                   P
P                                                                                                                                                   P
P                                                                                                                                                   P
P                                                                                                                                                   P
P                                                                                                                                                   P
P                                                                                                                                                   P
P                                                                                                                                                   P
P                PPPPPPPPPP                                                                          PPPPPPPP                                       P
P                                                                                                                                                   P
P                                                                                                                                                   P
P                                                                                                                                                   P
P                                                                                                                                                   P
PPPPPPPPPPPPPPPPPPPPPPPPPPPPPPPPPPPPPPPPPPPPPPPPPPPPPPPPPPPPPPPPPPPPPPPPPPPPPPPPPPPPPPPPPPPPPPPPPPPPPPPPPPPPPPPPPPPPPPPPPPPPPPPPPPPPPPPPPPPPPPPPPPPPP